.....X..:X
XXXX.X.XXX
.....X..X.
.XXX..X..X
.X..X.XX.X
...XX.XX.X
.X.XX....X
.X...XXXX.
XX.X.X.XX.
E..X...X..